#########################
#__________B_____BB____BB
#___BB_____B_____BB____BB
#BBBBB_____B_____BB____BB
#__________BBB__________#
#_______________________#
BBBBBBB_________________#
#__B______BBBB_____BBBBBB
#__B_______________B___B#
#__B_______________B___B#
#__B______BBBB__BBBB____#
#__B______BBBB__BBBB____#
#__B_______________B____#
#_______________________#
#_______________________#
#_________BBBB__________#
#_________BFFB__________#
##########BFFB###########
