##########BFFB###########
#_________BFFB___BB____BB
#_________BBBB___BB____BB
#BBBBB___________BB____BB
#_________BBBB__________#
#_______________________#
BBBBBBB_________________#
#__B______BBBB_____BBBBBB
#__B______BBBB_____B___B#
#__B_______________B___B#
#__B______BBBB__BBBB____#
#__B______BBBB__BBBB____#
#__B_______________B____#
#_______________________#
#_______________________#
#_________BBBB__________#
#_________BFFB__________#
##########BFFB###########
